## Nouns
hook - крюк
observer - наблюдатель
dispatch - отправка, быстрое выполнение
maintenance - поддержка

## Adjective
versatile - универсальный
separate - отдельный
bundle - пакет
precise - точный, четкий
refused - отвергнутый
expensive - дорогой

 ## Verb
 allow - разрешать
 fiddle - играть
 perform - выполнять
 interaction - взаимодействие
 overflow - разливаться
 stretch - растягивать
 truncate - усекать
 deploy - развернуть

in particular - в частности
useless - бесполезный
explicity - явно
thoroughly - тщательно
propagation - распространение
necessary - необходимо
therefore - поэтому
accident - несчастный случай
failure - ошибка
recently - недавно
inspiration - вдохновлять
postpone - отложить
suspense - неизвестность
implement - реализация
thus - следовательно
