backup - резервное копирование
to boot - загружать
to burn - записывать на оптический диск
to compile - компилировать
to eject - извлекать
to implement - внедрять
advantage - преимущество
legacy - достояние, наследство
a bus - шина
a kernel - ядро
flush - смыть
exсeption - исключение
artisan - ремесленник
template - шаблон
pattern - образец
survive - выжить
vendor - поставщик
assets - активы
enumeration - перечесление
extension - расширение
denied - отказано
exclude - исключать
restrict - ограничивать
omit - пренебрегать
guest - гость
revert - возвращать
prohibit - препятствовать
bound - связывание
compose - сочинять
shuffle - смешивать
flip - переворачивать
void - пустота
generic - универсальный
anchor - якорь
prepend - добавлять
changeover - переключение
